+--+--+--+--+--+
|              |
+  +  +--+--+  +
|  |        |  |
+--+--+--+  +  +
|     |     |  |
+  +  +  +--+  +
|  |     |  |  |
+  +--+--+  +  +
|  |          g|
+--+--+--+--+--+